. . . . . . . . . . . . . . . .
. . . . . . . . . . . . . . . .
. . # # # # # . . . . . . . . .
. . # . . . # . # # # E . . . .
. . # . S . # . # . . . . . . .
. . # . # . # . # . # # # . . .
. . # . # . # . # . # . # . . .
. . # . # . # . # . # . # . . .
. . # . # . # # # . # . # . . .
. . # . # . . . . . # . # . . .
. . # . # # # # # # # . # . . .
. . # . . . . . . . . . # . . .
. . # . . . . . . . . . # . . .
. . # # # # # # # # # # # . . .
. . . . . . . . . . . . . . . .
. . . . . . . . . . . . . . . .