. . . . . . . . . . . . . . .
. . . . . . . . . . . . . . .
. . # # # # # . . . . . . . .
. . # . . . # . # # # E . . .
. . # . S . # . # . . . . . .
. . # . # . # . # . # # # . .
. . # . # . # . # . # . # . .
. . # . # . # . # . # . # . .
. . # . # . # # # . # . # . .
. . # . # . . . . . # . # . .
. . # . # # # # # # # . # . .
. . # . . . . . . . . . # . .
. . # . . . . . . . . . # . .
. . # # # # # # # # # # # . .
. . . . . . . . . . . . . . .
. . . . . . . . . . . . . . .